LLLICH_PHYLACTERY_ACTIVE_DisplayName	Undying		
LLLICH_PHYLACTERY_ACTIVE_Description	Character is immortal through the power of a Phylactery.<br><font color='#73F6FF' size='19'>Phylactery Powers Unlocked</font>		
LLLICH_RECOVERING_ACTIVE_DisplayName	Regenerating		
LLLICH_RECOVERING_ACTIVE_Description	Character is slowly regenerating through the power of a Phylactery.		
LLLICH_CREATE_PHYLACTORY_DisplayName	Phylactery Creation		
LLLICH_LICHFORM_DisplayName	Lich Form		
LLLICH_LICHFORM_Description	Character is an immortal, undead sorcerer.<br><font color='#C7A758'>Immunity to Bleeding & Suffocating</font><br><font color='#C7A758'>Chance to Resist Fear & Stunned</font><br><font color='#B823CB'>Lich Powers Unlocked</font>		
LLLICH_DREAD_DisplayName	Dread		
LLLICH_DREAD_Description	Character is full of dread.<br>If killed, may spread Fear or Madness to other characters with Dread.		
LLLICH_PARALYZE_DisplayName	Stunned or Knocked Down		
LLLICH_FLESH_SACRIFICE_DisplayName	Blood Sacrifice		
LLLICH_FLESH_SACRIFICE_Description	Character has sacrificed the blood of a living being.		
LLLICH_FLESH_SACRIFICE_DEBUFF_Description	Character's blood has been sacrificed.		
LLLICH_FLESH_SACRIFICE_DEBUFF_DisplayName	Sacrificed		
LLLICH_DEATH_MARK_DisplayName	Death Mark		
LLLICH_DEATH_MARK_Description	If killed, character's soul will erupt, dealing damage within a [1]m range.		
LLLICH_CHILLFORM_DisplayName	Death's Embrace		
LLLICH_CHILLFORM_Description	Character has an icey aura of death.<br><font color='#b8caff'>When turn ends, remove <font color='#FE6E27'>Burning</font> and <font color='#FF9600'>Warm</font> from allies, apply <font color='#4197E2'>Chilled</font> to enemies, and <font color='#97FBFF'>leach health from Frozen enemies.</font></font>		
LLLICH_CHILLFORM_SPEEDBOOST_DisplayName	Frozen Celerity		
LLLICH_CHILLFORM_SPEEDBOOST_Description	Character moves faster on ice.		
LLLICH_CHILLFORM_LIFESTEAL_DisplayName	Drain Frozen		
LLLICH_CHILLFORM_AURA_ALLY_DisplayName	Cooling (Death's Embrace)		
